****************
*         *   E*
*  * *    *  ***
*  ***    *  * *
*    *  ***    *
**** *  * *    *
*S   *         *
****************