****************
*         *   E*
*  * *    *  ***
*  ***    *  * *
*    *  ***    *
**   *  * *    *
*S       *******
   *         ***
*              * 
****************